11,26
%%%%%%%%%%%%%%%%%%%%%%%%%%
%................%%%...%%%
%.%%%%%%%.%%.%%%%%%%.%%%%%
%......%%.%%.%%%.....%%%.%
%%%.%%.%%.%..%%..%%%...%.%
e...%%.%%.%.%%%%.%%%.%%%.%
%%%.%..%%.%.%....%...%%..%
%%%.%%%%%.%%%.%%%%%%....%%
%.....%%%.%%%....%%%.%.%%%
%.%%%.%%%.....%%.%%..%...x
%%%%%%%%%%%%%%%%%%%%%%%%%%